000000000000000000000000
010121212121212121212120
012121212121212121212120
012121212121212121212120
012121212121212121212120
012121212121212121212120
012121212121212121212120
011111111111111111111110
012121212121212121212120
012121212121212121212120
012121212121212121212120
012121212121212121212120
012121212121212121212120
012121212121212121212120
012121212121212121212120
000000000000000000000000