333333333333333333333333
000000000000000000000000
011524212121212121212120
010102010101010101010120
042121212125212121212120
010101010101010101010120
012141212121242122212120
010101010101010101010120
011111111111111111111110
010101010101010101010120
012221212121212121212120
010101010101010101010120
012121212121212121212120
010101010101010101010120
012121212121212121212120
000000000000000000000000