333333333333333333333333
000000000000000000000000
012121212121212121212120
012121212121212121212120
012121212121212121212120
012121212121212121212120
012121212121212121212120
012121212121212121212120
011111111111111111111110
012121212121212121212120
012121212121212121212120
012121212121212121212120
012121212121212121212120
012121212121212121212120
012121212121212121212120
000000000000000000000000