333333333333333333333333
000000000000000000000000
011524212121212121212120
010102010101010101010120
042121212125212121212120
010101010101010101010120
012141212121242122212120
010101010101010101010120
011111111111111111111110
010201020101050104010220
012221212421212521222120
010401020102010101020120
012421252121212221222120
010102010501040101040520
012121222121212122212120
000000000000000000000000