333333333333333333333333
000000000000000000000000
015121212121212121212120
010101010101010101010120
012121212121212121212120
010101212121212121212120
012121212121212121212120
010121212121212121212120
011111111111111111111110
010121212121212121212120
012121212121212121212120
010121212121212121212120
012121212121212121212120
010121212121212121212120
012121212121212121212120
000000000000000000000000